R 500 500
NO ./murouest.xpm
SO ./murest.xpm
WE ./murouest.xpm
EA ./murest.xpm
S ./regle.xpm
F 255,100,0
C 225,30,0

11111111111
10000000001
10000000001
10000000001
10000200001
10000000001
10000000001
10000N00001
11111111111
