R 1000 1000
NO ./murouest.xpm
SO ./murest.xpm
WE ./murouest.xpm
EA ./murest.xpm
S ./virus.xpm
F 25   ,   100,0
C 225,30,0

  11111
1110001
1100201
1002001
1000001
1E00001
1111111