R 200 200
NO ./pink2.xpm
SO ./sky_text.xpm
WE ./tropical.xpm
EA ./murest.xpm
S ./virus.xpm
F 150, 150, 150

C 255,140,241

11111111111111111111111111111
11111000000000000000000001111
11000000100000111111111101111111
  0010000 0000000000000000000001
11110000011100N00000000000000001
10000000001100000111011110001111
11110111111111011100000010001
11110111111111011101010010001
11000011110101011100000010001
1000201  10000001100000010001
1111111  11111111111111111111