R 1000 1000
NO ./murouest.xpm
SO ./murest.xpm
WE ./murouest.xpm
EA ./murest.xpm
S ./virus.xpm
F 255,100,0
C 225,30,0

  111  111              
10200002001  
12000  200201
10000200001  
1200  0200021
10000000  0010
1020 0002001 
12000N00021  
11111         111111
