R 1000 1000
NO ./pink2.xpm
SO ./sky_text.xpm
WE ./tropical.xpm
EA ./tropical.xpm
S ./pink2.xpm
F 255,100,0
C 225,30,0

11111111111111111111111111111  
11111000000000000000000001111  
10000000100000111111111101111  
1001000000000000000000000000111
10110000011100N0000000000000001
1000000000110000011101111000111
11110111111111011100000010001  
11110111111111011101010010001  
11000000110101011100000010001  
10002000000000001100000010001  
11111111111111111111111111111  
