R 1000 1000
NO ./murouest.xpm
SO ./murest.xpm
WE ./murouest.xpm
EA ./murest.xpm
S ./virus.xpm
F 25,10,50
C 25,130,20

  111  111              
10200002001  
12000  200201
10000200001  
1200  0200021
10000000  001
1020 0002001   
12000N00021  
11111         111111
