R 1920 1080
NO ./murest.xpm
SO ./murest.xpm
WE ./murest.xpm
EA ./murest.xpm
S ./virus.xpm
F 255,100,0
C 225,30,0

1 1 1 1 1
1 1 1 1 1
1 0 0 1 1
1 0 0 1 1
1 0 0 1 1
1 0 0 1 1
1 0 0 1 1
1 0 0 1 1
1 0 0 1 1
1 0 0 1 1
1 0 0 1 1
1 0 0 1 1
1 0 0 1 1
1 0 0 1 1
1 0 0 1 1
1 0 0 1 1
1 0 0 0 1
1 1 1 1 1
1 0 1 0 1
1 0 0 0 1
1 0 N 0 1
1 0 0 0 1
1 1 1 1 1
