R 1000 1000
NO ./murouest.xpm
SO ./murest.xpm
WE ./murouest.xpm
EA ./murest.xpm
S ./virus.xpm
F 255,100,0
C 225,30,0

11111111111
10200002001
12000200201
10000200001
12000200021
10000000001
10200002001
12000N00021
11111111111
